99999999999999
90000000000669
90000000000669
91111220000669
91111220000669
95555220000660			
95555220000660
90033220077779
90033220077779
90033004444449
90033004444449
90000000000009
90000000000009
99999999999999