99999999999999
90000000000009
90000000000009
90000111100009
90000111100009
95555332266000
95555332266000
90000332266009
90000332266009
94444442266009
94444442266009
90000000000009
90000000000009
99999999999999