99999999999999
90000000022009
90000000022009
90000000022339
90000000022339
91111555522330		
91111555522330
98800444444669
98800444444669
98800007777669
98800007777669
98800000000669
98800000000669
99999999999999