99999999999999
95555000000009
95555000000009
90022000000009
90022000000009
90022000000009
90022000000009
90022004444449
90022004444449
90011113300009
90011113300009
90000003300009
90000003300009
99900999999999