99999999999999
90000555500009
90000555500009
90000660000009
90000660000009
90022660000009
90022660000009
90022664444449
90022664444449
90022000000339
90022000000339
91111007777339
91111007777339
99900999999999