99999999999999
90022000000009
90022000000009
90022000000009
90022000000009
90022000000009
90022000000009
91111003300009
91111003300009
94444443300009
94444443300009
90000000000009
90000000000009
99900999999999