99999999999999
90000003300229
90000003300229
94444443300229
94444443300229
95555667777229
95555667777229
90000660088009
90000660088009
90000660088009
90000660088009
90000111188009
90000111188009
99999990099999