99999999999999
90000003300009
90000003300009
90000003300009
90000003300009
90066885555009			
90066885555009
92266884444449
92266884444449
92266880000009
92266880000009
92277771111009
92277771111009
99999990099999