99999999999999
90044444400009
90044444400009
90000663300009
90000663300009
90022663300009			
90022663300009
90022660088009
90022660088009
90022555588009
90022555588009
91111777788009
91111777788009
99999990099999