99999999999999
90000000000009
90000000000009
90000000022009
90000000022009
90011113322000
90011113322000
90000003322009
90000003322009
90000004444449
90000004444449
90000000000009
90000000000009
99999999999999