99999999999999
95555006600889
95555006600889
92200006600889
92200006600889
92211116633880
92211116633880
92200000033009
92200000033009
90000000077779
90000000077779
90000004444449
90000004444449
99999999999999