99999999999999
90000002200009
90000002200009
90000002200009
90000002200009
91111002200000
91111002200000
90000000000009
90000000000009
93300444444009
93300444444009
93300005555009
93300005555009
99999999999999