99999999999999
95555000000889
95555000000889
92200006600889
92200006600889
92211116600880
92211116600880
92200006600009
92200006600009
93300000077779
93300000077779
93300444444009
93300444444009
99999999999999